_test_map_TILEMAP:
*37 Width
*23 Height
*2  Texture
ZRRRRRRRRRRRRRRRRRRRRRRRRRRRRRRRRRWZZ
S0000000000000000000G0000000000000TZZ
S00000F000000000000000000000000000TZZ
S0000000000000000000G0000000000000TZZ
S00220000000EEEEE00000000000000000TZZ
S05114000F00D0F0C00000000000000000TZZ
S05114000000D000C000F0000000000000TZZ
S05114000010AEEEB00000000000000000TZZ
S051140000000000000000000000000000TZZ
S00330000000G0000000FF000000000000TZZ
S0000000000000000000FF000000000000TZZ
S00000000000000G000000G00000000000TZZ
S00000F000000000000000G00000000000TZZ
S000000000000000000000G00000000000TZZ
S00GG00000000000000000G00000000000TZZ
S00GG00000000000000000G00000000000TZZ
S0000000NNNNNQQQQ00000000000000000TZZ
S0000000MMMMMPPPP00000000000000000TZZ
S0000000KKLKKHHJI00000000000000000TZZ
S000000000000000000000000000000000TZZ
VUUUUUUUUUUUUUUUUUUUUUUUUUUUUUUUUUZZZ
ZZZZZZZZZZZZZZZZZZZZZZZZZZZZZZZZZZZZZ
ZZZZZZZZZZZZZZZZZZZZZZZZZZZZZZZZZZZZZ

_test_map_COLLISIONMAP:
*1  Transition count
*2  Encounter count
1111111111111111111111111111111111111
100000000AAAA000000010000000000000111
100000000AAAA0000000b0000000000000111
100000000AAAA000000010000000000000111
1000000000001111100000000000000000111
100aa00000001000100000000000000000111
100aa00000001000100000000000000000111
100aa00000001111100000000000000000111
100aa00000000000000000000000000000111
1000000000001000000000000000000000111
1000000000000000000000000000000000111
1000000000000001000000100000000000111
1000000000000000000000100000000000111
1000000000000000000000100000000000111
1001100000000000000000100000000000111
1001100000000000000000100000000000111
1000000011111111100000000000000000111
1000000011111111100000000000000000111
1000000011111111100000000000000000111
1000000000000000000000000000000000111
1111111111111111111111111111111111111
1111111111111111111111111111111111111
1111111111111111111111111111111111111
&_test_town_TILEMAP
*10 Spawn X tile
*10 Spawn Y tile
&_grass_ENCOUNTER
%0.33 chance
&_matt_ENCOUNTER
%1.01 chance
